tepid adj. 微温的，温热的；不太热烈的；不热情的 = lukewarm adj. 冷淡的；微温的；不够热心的
indecorous adj. 不合礼节的，不得体的 = unseemly adj. 不适宜的；不得体的 adv. 不得体地；不适宜地
restive adj. 倔强的；难驾御的；不安宁的 = skittish adj. （人或动物）不安的，易受惊的；难驾驭的；（人）轻佻的，善变的 = restless
exacting adj. 费劲的;需细致小心的 (标准)严格的,难达到的 (对别人)严格的,苛求的 = meticulous adj. 极仔细的; 一丝不苟的
miserliness = stinginess = illiberality 吝啬 小气
convoluted adj. 复杂的；费解的；旋绕的 = complicated = involved
frugality = thrift 节俭
scathing adj. 尖锐的; 刻薄的 = acerbic
agree on = consent to
be deprived of = be withheld from
dampen vt. 抑制 = check
doctrinaire = dictatorial adj. 教条(主义)的；adj. 独裁的，专政的；专横傲慢的
fragility = vulnerability n. 脆弱
environment = surroundings
have a repugnance to doing = have an aversion of doing 反感做某事
counterparts = equivalents
provincial = endemic = local
singular = preeminent 卓越的，非凡的
opacity = obscurity n. 费解，晦涩难懂
scent = fragrance(常褒义)  n. 香味
fundamental = essential
transitory = ephemeral adj. 短暂的
insincere = hypocritical 不诚恳的；虚伪的
irrelevant = extraneous 无关的
debacle = fiasco 惨败
imitate = simulate = mimic 模仿
narrow = circumscribed = limited
lethal = deadly = fatal 致命的
grudging = reluctant adj. 不情愿的
inexhaustible = copious
reconcile = resolve
anomalous = irregular
laud = praise 咱么称赞
callous = merciless = ruthless = relentless adj. 无情残酷的
be enchanted by = be enamored of adj. 迷恋的
vitiate = debilitate = undermine vt. 削弱
schism = dichotomy n. 分裂
serene = tranquil adj. 安宁的
mercurial = inconstant adj. 易变化的
lukewarm = tepid adj. 微温的，不热情的
disgrace = humiliate vt. 羞辱
discomfited = embarrassed adj. 尴尬的
neat = tidy adj. 整齐的
hodgepodge = welter n. 混乱；大杂烩
